"filename", "language", "C++", "comment", "blank", "total"
"e:\C++自写项目\服务器\Server\day22\src\HttpBase\Bridge.cpp", "C++", 32, 0, 13, 45
"e:\C++自写项目\服务器\Server\day22\src\HttpBase\HttpController.cpp", "C++", 69, 4, 17, 90
"e:\C++自写项目\服务器\Server\day22\src\HttpBase\HttpHandler.cpp", "C++", 59, 3, 23, 85
"e:\C++自写项目\服务器\Server\day22\src\HttpBase\ReadBuffer.cpp", "C++", 93, 6, 28, 127
"e:\C++自写项目\服务器\Server\day22\src\HttpBase\RequestHandler.cpp", "C++", 145, 37, 32, 214
"e:\C++自写项目\服务器\Server\day22\src\HttpBase\ResponseHandler.cpp", "C++", 213, 30, 30, 273
"e:\C++自写项目\服务器\Server\day22\src\HttpBase\WriteBuffer.cpp", "C++", 64, 1, 25, 90
"e:\C++自写项目\服务器\Server\day22\src\HttpBase\include\Bridge.h", "C++", 19, 0, 17, 36
"e:\C++自写项目\服务器\Server\day22\src\HttpBase\include\HttpController.h", "C++", 21, 0, 15, 36
"e:\C++自写项目\服务器\Server\day22\src\HttpBase\include\HttpHandler.h", "C++", 23, 1, 24, 48
"e:\C++自写项目\服务器\Server\day22\src\HttpBase\include\ReadBuffer.h", "C++", 25, 4, 21, 50
"e:\C++自写项目\服务器\Server\day22\src\HttpBase\include\RequestHandler.h", "C++", 38, 1, 26, 65
"e:\C++自写项目\服务器\Server\day22\src\HttpBase\include\ResponseHandler.h", "C++", 30, 1, 16, 47
"e:\C++自写项目\服务器\Server\day22\src\HttpBase\include\WriteBuffer.h", "C++", 23, 3, 22, 48
"e:\C++自写项目\服务器\Server\day22\src\SockBase\Acceptor.cpp", "C++", 29, 1, 15, 45
"e:\C++自写项目\服务器\Server\day22\src\SockBase\Connection.cpp", "C++", 55, 4, 18, 77
"e:\C++自写项目\服务器\Server\day22\src\SockBase\HeapTimer.cpp", "C++", 179, 4, 52, 235
"e:\C++自写项目\服务器\Server\day22\src\SockBase\Reactor.cpp", "C++", 115, 0, 60, 175
"e:\C++自写项目\服务器\Server\day22\src\SockBase\Server.cpp", "C++", 145, 2, 16, 163
"e:\C++自写项目\服务器\Server\day22\src\SockBase\Socket.cpp", "C++", 92, 0, 58, 150
"e:\C++自写项目\服务器\Server\day22\src\SockBase\SocketHandler.cpp", "C++", 88, 2, 31, 121
"e:\C++自写项目\服务器\Server\day22\src\SockBase\ThreadPool.cpp", "C++", 35, 1, 10, 46
"e:\C++自写项目\服务器\Server\day22\src\SockBase\include\Acceptor.h", "C++", 19, 2, 13, 34
"e:\C++自写项目\服务器\Server\day22\src\SockBase\include\Connection.h", "C++", 31, 9, 21, 61
"e:\C++自写项目\服务器\Server\day22\src\SockBase\include\HeapTimer.h", "C++", 64, 17, 53, 134
"e:\C++自写项目\服务器\Server\day22\src\SockBase\include\Reactor.h", "C++", 45, 9, 34, 88
"e:\C++自写项目\服务器\Server\day22\src\SockBase\include\Server.h", "C++", 39, 6, 20, 65
"e:\C++自写项目\服务器\Server\day22\src\SockBase\include\Socket.h", "C++", 43, 6, 37, 86
"e:\C++自写项目\服务器\Server\day22\src\SockBase\include\SocketHandler.h", "C++", 41, 18, 32, 91
"e:\C++自写项目\服务器\Server\day22\src\SockBase\include\ThreadPool.h", "C++", 32, 12, 16, 60
"e:\C++自写项目\服务器\Server\day22\src\SockBase\include\util.h", "C++", 47, 5, 16, 68
"e:\C++自写项目\服务器\Server\day22\src\SockBase\util.cpp", "C++", 16, 0, 12, 28
"Total", "-", 1969, 189, 823, 2981